location	country
"Buenos Aires"	"Argentinia" 
"Tirana"	"Albania" 
"Melbourne"	"Australia" 
"North Sydney"	"Australia" 
"Sydney"	"Australia" 
"Brisbane"	"Australia" 
"Vienna"	"Austria" 
"Baku"	"Azerbaijan" 
"Brussels"	"Belgium" 
"Antwerp"	"Belgium" 
"Dhaka"	"Bangladesh" 
"Manaus, Amazonas"	"Brazil" 
"Rio de Janeiro"	"Brazil" 
"Belo Horizonte, Minas Gerais"	"Brazil" 
"São Paulo, São Paulo"	"Brazil" 
"Goiânia"	"Brazil" 
"Belém, Pará"	"Brazil" 
"Brasília, Federal District"	"Brazil" 
"Campina Grande, Paraíba"	"Brazil" 
"Campo Grande, Mato Grosso do Sul"	"Brazil" 
"Sofia"	"Bulgaria" 
"Kanata, ON"	"Canada" 
"Mississauga, ON"	"Canada"
"Burnaby, BC"	"Canada" 
"Montreal, QC"	"Canada" 
"Calgary, AB"	"Canada" 
"Ontario, CA"	"Canada" 
"Toronto, ON"	"Canada" 
"Ottawa, ON"	"Canada" 
"Surrey, BC"	"Canada" 
"Vancouver, BC"	"Canada" 
"Markham, ON"	"Canada" 
"Santiago"	"Chile" 
"Daxing, Beijing"	"China" 
"Shenzhen, Guangdong"	"China" 
"Guangzhou, Guangdong"	"China" 
"Shanghai, Shanghai"	"China" 
"Hangzhou, Zhejiang"	"China" 
"Beijing, Beijing"	"China" 
"Qingdao, Shandong"	"China" 
"Pudong, Shanghai"	"China" 
"South China, ME"	"China" 
"Nanjing, Jiangsu"	"China" 
"Chengdu, Sichuan"	"China" 
"Bogotá, Bogota"	"Colombia" 
"Copenhagen"	"Denmark" 
"Cairo"	"Egypt" 
"Addis Ababa"	"Ethopia" 
"Helsinki, Western Finland"	"Finland" 
"Salo, Western Finland"	"Finland" 
"Tampere"	"Finland" 
"Helsinki, Southern Finland"	"Finland" 
"Espoo"	"Finland" 
"Oulu"	"Finland" 
"Nokia"	"Finland" 
"Nozay, Ile-de-France"	"France" 
"Paris"	"France" 
"Lannion"	"France" 
"Boulogne-Billancourt"	"France" 
"Stuttgart"	"Germany" 
"Berlin"	"Germany" 
"Munich, Bavaria"	"Germany" 
"Ulm, Baden-Wurttemberg"	"Germany" 
"Frankfurt am Main"	"Germany" 
"Bochum, North Rhine-Westphalia"	"Germany" 
"Nuremberg"	"Germany" 
"Düsseldorf"	"Germany" 
"Athens"	"Greece" 
"Accra"	"Ghana" 
"Guatemala City"	"Guatemala" 
"Hong Kong"	"Hong Kong" 
"Budapest"	"Hungary" 
"Buda, Budapest"	"Hungary" 
"Cochin"	"India" 
"Bangalore Rural"	"India" 
"Pune"	"India" 
"Karnāl"	"India" 
"Indi, Karnataka"	"India" 
"Greater Noida"	"India" 
"Indore"	"India" 
"Guindy"	"India" 
"Jaipur, Rajasthan"	"India" 
"Dondaicha"	"India" 
"Safidon"	"India" 
"Pune City"	"India" 
"Sambalpur, Orissa"	"India" 
"Āsansol, West Bengal"	"India" 
"Mohāli, Maharashtra"	"India" 
"Aurangābād, Maharashtra"	"India" 
"Ahmedabad"	"India" 
"Murray Hill, Gurgaon, Haryana"	"India" 
"Gurgaon, Haryana"	"India" 
"New Delhi"	"India" 
"Lucknow"	"India" 
"Shillong"	"India" 
"Gwalior, Madhya Pradesh"	"India" 
"Kānchipuram"	"India" 
"Chennai"	"India" 
"Mumbai"	"India" 
"Noida"	"India" 
"Bangalore"	"India" 
"Jhānsi"	"India" 
"Hyderābād"	"India" 
"Calcutta"	"India" 
"Oragadam"	"India" 
"Belonia"	"India" 
"Bhopal"	"India" 
"Bhubaneshwar"	"India" 
"Bhāvnagar"	"India" 
"Jakarta"	"Indonesia" 
"Balikpapan"	"Indonesia" 
"Tehran, Tehran"	"Iran" 
"Bābol Sar"	"Iran" 
"Baghdad"	"Iraq" 
"Arbīl"	"Iraq" 
"Dublin, Dublin"	"Ireland" 
"Blanchardstown"	"Ireland" 
"Tel Aviv-Yafo"	"Israel" 
"Hod HaSharon"	"Israel" 
"Milan"	"Italy" 
"Milano"	"Italy" 
"Rome"	"Italy" 
"Belluno"	"Italy" 
"Abidjan"	"Ivory Coast" 
"Tokyo"	"Japan" 
"Ammān"	"Jordan" 
"Nairobi"	"Kenya" 
"Beirut"	"Lebanon" 
"Kuala Lumpur"	"Malaysia" 
"Rabat"	"Marocco" 
"Ciudad de México"	"Mexico" 
"Monterrey, Nuevo León"	"Mexico" 
"Cuautitlán Izcalli"	"Mexico" 
"Rangoon"	"Myanmar" 
"Amsterdam"	"Netherlands" 
"Auckland, Auckland"	"New Zealand" 
"Wellington, Wellington"	"New Zealand" 
"Abuja Nigeria"	"Nigeria" 
"Abuja, Federal Capital Territory"	"Nigeria" 
"Lagos"	"Nigeria" 
"Oslo"	"Norway" 
"Islamabad, Islamabad"	"Pakistan" 
"Karāchi"	"Pakistan" 
"Islamabad, Islamabad"	"Pakistan" 
"Quezon City, National Capital Region"	"Philippines" 
"Manila, Manila"	"Philippines" 
"Wrocław"	"Poland" 
"Kraków"	"Poland" 
"Warsaw"	"Poland" 
"Bydgoszcz"	"Poland" 
"Lisbon"	"Portugal" 
"Amadora"	"Portugal" 
"Porto, Oporto"	"Portugal" 
"Alfragide"	"Portugal" 
"Ílhavo"	"Portugal" 
"Aveiro"	"Portugal" 
"Timişoara"	"Romania" 
"Bucharest"	"Romania" 
"Cluj-Napoca"	"Romania" 
"Saint Petersburg"	"Russia" 
"Rostov-na-Donu"	"Russia" 
"Moscow"	"Russia" 
"Voronezh, Voronezhskaya Oblast"	"Russia" 
"Riyadh"	"Saudi Arabia" 
"Mecca"	"Saudi Arabia" 
"Belgrade"	"Serbia" 
"Singapore"	"Singapore" 
"Bedok New Town, East"	"Singapore" 
"Bukit Merah Estate, Central"	"Singapore" 
"Bratislava"	"Slovakia" 
"Johannesburg"	"South Africa" 
"Seoul"	"South Korea" 
"Córdoba"	"Spain" 
"Madrid"	"Spain" 
"Barcelona"	"Spain" 
"Kista"	"Sweden" 
"Stockholm, Stockholm"	"Sweden" 
"Geneva"	"Switzerland" 
"Bangkok"	"Thailand" 
"Ksar el Kradem"	"Tunisia" 
"Bārdaw"	"Tunisia" 
"Istanbul"	"Turkey" 
"Ankara"	"Turkey" 
"Dubai"	"UAE" 
"Kampala"	"Uganda" 
"Cambridge, England"	"UK" 
"Reading, England"	"UK" 
"Woolwich, England"	"UK" 
"London, England"	"UK" 
"Harefield, England"	"UK" 
"Bristol, England"	"UK" 
"Ipswich, England"	"UK" 
"Farnborough, Hampshire, South East England, England"	"UK" 
"Birmingham, England"	"UK" 
"Huntingdon and Peterborough, England"	"UK" 
"Huntingdon, England"	"UK" 
"Greenwich, England"	"UK" 
"Fleet, South East England, England"	"UK" 
"Farnborough, London, England"	"UK" 
"Solihull, England"	"UK" 
"Swindon, Gloucestershire, South West England, England"	"UK" 
"Kiev"	"Ukraine" 
"Bothell, WA"	"US" 
"White Plains, NY"	"US" 
"Fresno, CA"	"US" 
"Buford, GA"	"US" 
"Mount Prospect, IL"	"US" 
"Burlington, VT"	"US" 
"Gainesville, VA"	"US" 
"Remote, OR"	"US" 
"Brooksville, FL"	"US" 
"Reno, NV"	"US" 
"Edmond, OK"	"US" 
"Baltimore, MD"	"US" 
"Germany, GA"	"US" 
"Fort Worth, TX"	"US" 
"Encino, CA"	"US" 
"Arlington Heights, Cook, IL"	"US" 
"Saint Louis, MO"	"US" 
"Athens, GA"	"US" 
"Boulder, CO"	"US" 
"Roswell, GA"	"US" 
"Arlington, TX"	"US" 
"Seattle, WA"	"US" 
"Denver, CO"	"US" 
"Cambridge, MA"	"US" 
"Boston, MA"	"US" 
"Dublin, OH"	"US" 
"Holmdel, NJ"	"US" 
"Itasca, IL"	"US" 
"Malvern, PA"	"US" 
"Schaumburg, IL"	"US" 
"Cary, NC"	"US" 
"Morocco, IN"	"US" 
"Burnsville, MN"	"US" 
"Detroit, MI"	"US" 
"Cleveland, OH"	"US" 
"Miami, FL"	"US" 
"Philadelphia, PA"	"US" 
"Oswego, IL"	"US" 
"Coral Springs, FL"	"US" 
"Simsbury, CT"	"US" 
"Carlsbad, CA"	"US" 
"Leesburg, VA"	"US" 
"Alpharetta, GA"	"US" 
"Switzerland, SC"	"US" 
"Fargo, ND"	"US" 
"Rancho Bernardo, CA"	"US" 
"Richmond, VA"	"US" 
"Iselin, NJ"	"US" 
"San Mateo, CA"	"US" 
"Santa Clara, CA"	"US" 
"Munich, ND"	"US" 
"Fairfax, VA"	"US" 
"Jacksonville, FL"	"US" 
"Frisco, TX"	"US" 
"Keller, TX"	"US" 
"Bedminster, NJ"	"US" 
"Methuen, MA"	"US" 
"El Cajon, CA"	"US" 
"Coppell, TX"	"US" 
"Hoffman Estates, IL"	"US" 
"Dunstable, MA"	"US" 
"Aiken, SC"	"US" 
"Korea, KY"	"US" 
"Deland, FL"	"US" 
"Turkey, TX"	"US" 
"North Andover, MA"	"US" 
"Algonquin, IL"	"US" 
"Palo Alto, CA"	"US" 
"Kansas City, MO"	"US" 
"Kansas City, KS"	"US" 
"Pembroke Pines, FL"	"US" 
"North Chicago, IL"	"US" 
"Roselle, IL"	"US" 
"Austin, TX"	"US" 
"Murray Hill, NJ"	"US" 
"Arlington Heights, IL"	"US" 
"Calabasas, CA"	"US" 
"Houston, TX"	"US" 
"Richardson, TX"	"US" 
"Hartford, CT"	"US" 
"Redmond, WA"	"US" 
"Saint Cloud, MN"	"US" 
"Burlington, MA"	"US" 
"Oklahoma City, OK"	"US" 
"Charlotte, NC"	"US" 
"Flower Mound, TX"	"US" 
"San Jose, CA"	"US" 
"New Providence, Union, NJ"	"US" 
"Westmont, IL"	"US" 
"Carrollton, TX"	"US" 
"Tempe, AZ"	"US" 
"Boca Raton, FL"	"US" 
"San Antonio, TX"	"US" 
"Greenville, NC"	"US" 
"San Diego, TX"	"US" 
"Birmingham, AL"	"US" 
"Los Angeles, CA"	"US" 
"Irving, TX"	"US" 
"San Diego, CA"	"US" 
"Tampa, FL"	"US" 
"New Brunswick, NJ"	"US" 
"San Francisco, CA"	"US" 
"Sunnyvale, CA"	"US" 
"Sandy Springs, Fulton, GA"	"US" 
"Plano, TX"	"US" 
"Atlanta, GA"	"US" 
"Ann Arbor, MI"	"US" 
"Westford, MA"	"US" 
"Phoenix, AZ"	"US" 
"Chicago, IL"	"US" 
"Elizabeth, NJ"	"US" 
"New Providence, NJ"	"US" 
"Newark, NJ"	"US" 
"Raleigh, NC"	"US" 
"Columbus, OH"	"US" 
"Dallas, TX"	"US" 
"New York, NY"	"US" 
"Bellevue, WA"	"US" 
"Naperville, IL"	"US" 
"Mountain View, CA"	"US" 
"Hanoi"	"Vietnam" 
"Cupertino, CA"	"US"
"Cork"	"UK"
"Manchester, England"	"UK"
"Orlando, FL"	"US"
"Slough, Berkshire, South East England, England"	"UK"
"San Jose, San Jose"	"US"
"Glasgow, Scotland"	"UK"
"Sacramento, CA"	"US"
"Las Vegas, NV"	"US"
"Portland, OR"	"US"
"Cincinnati, OH"	"US"
"Washington, DC"	"US"
"Athlone"	"Ireland"
"Overland Park, KS"	"US"
"Elk Grove, CA"	"US"
"Edinburgh, Scotland"	"UK"
"Stockholm, Jämtland"	"Sweden"
"Salt Lake City, UT"	"US"
"Pittsburgh, PA"	"US"
"Swansea, Wales"	"UK"
"Coimbatore"	"India"
"Leeds, England"	"UK"
"Caracas, Capital District"	"Venezuela"
"Guildford, England"	"UK"
"Indianapolis, IN"	"US"
"Cape Town"	"South Africa"
"Brampton, ON"	"Canada"
"Herndon, VA"	"US"
"Luxembourg"	"Luxembourg"
"Nashville, TN"	"US"
"Piscataway, NJ"	"US"
"Prague"	"Czech Republic"
"Liverpool, England"	"UK"
"Minneapolis, MN"	"US"
"Arlington, VA"	"US"
"Belfast, Northern Ireland"	"UK"
"Irvine, CA"	"US"
"San Bernardino, CA"	"US"
"Aventura, FL"	"US"
"Moreno Valley, CA"	"US"
"Hebron, KY"	"US"
"Memphis, TN"	"US"
"Zagreb"	"Croatia"
"Honolulu, HI"	"US"
"Paramus, NJ"	"US"
"Rugeley, England"	"UK"
"Edison, NJ"	"US"
"Warrington, North West England, England"	"UK"
"Newcastle upon Tyne, England"	"UK"
"Hemel Hempstead, England"	"UK"
"Sheffield, England"	"UK"
"Southampton, England"	"UK"
"Edmonton, AB"	"Canada"
"Brooklyn, NY"	"US"
"Cardiff, Wales"	"UK"
"Coventry, England"	"UK"
"Kenosha, WI"	"US"
"Santa Barbara, CA"	"US"
"Costa Mesa, CA"	"US"
"Santa Monica, CA"	"US"
"Romulus, MI"	"US"
"Bethesda, MD"	"US"
"Tucson, AZ"	"US"
"Lima, Lima Region"	"Peru"
"Nottingham, England"	"UK"
"Tracy, CA"	"US"
"Dunfermline, Scotland"	"UK"
"Louisville, KY"	"US"
"Leicester, England"	"KS"
"Clearwater, FL"	"US"
"Robbinsville, NJ"	"US"
"Durham, NC"	"US"
"Staten Island, NY"	"US"
"Fort Lauderdale, FL"	"US"
"Mason, OH"	"US"
"Brighton, England"	"UK"
"Gothenburg"	"Sweden"
"Kent, WA"	"US"
"Colorado Springs, CO"	"US"
"Novi, MI"	"US"
"Troy, MI"	"US"
"York, England"	"UK"
"Milton Keynes, England"	"UK"
"Dunstable, England"	"UK"
"Lexington-Fayette, KY"	"US"
"Troutdale, OR"	"US"
"San Marcos, TX", "US"
"Newark, DE", "US"
"Norwich, England", "UK"
"Joliet, IL", "US"
"Madison, WI", "US"
"Aurora, CO", "US"
"Baton Rouge, LA", "US"
"Doncaster, England", "UK"
"Pasadena, CA", "US"
"Rancho Cucamonga, CA", "US"
"Short Hills, NJ", "US"
"Rialto, CA", "US"
"Milwaukee, WI", "US"
"Albany, NY", "US"
"Duluth, GA", "US"
"Greensboro, NC", "US"
"Scottsdale, AZ", "US"
"King of Prussia, PA", "US"
"Chandler, AZ", "US"
"Lahore", "Pakistan"
"Towson, MD", "US"
"Chattanooga, TN", "US"
"Tilbury, England", "UK"
"Peterborough, England", "UK"
"Reston, VA", "US"
"Norfolk, VA", "US"
"Newport Beach, CA", "US"
"Sherman Oaks, CA", "US"
"Lloydminster, AB"	"Canada"
"Balzac, AB"	"Canada"
"Saint Albert, AB"	"Canada"
"Red Deer, AB"	"Canada"
"Hinton, AB"	"Canada"
"Airdrie, AB"	"Canada"
"St. Albert, AB"	"Canada"
"Delta, BC"	"Canada"
"Richmond, BC"	"Canada"
"Victoria, BC"	"Canada"
"New Westminster, BC"	"Canada"
"Coquitlam, BC"	"Canada"
"Tsawwassen, BC"	"Canada"
"Prince George, BC"	"Canada"
"Kamloops, BC"	"Canada"
"Chilliwack, BC"	"Canada"
"Nanaimo, BC"	"Canada"
"Fernie, BC"	"Canada"
"Whistler, BC"	"Canada"
"Port Coquitlam, BC"	"Canada"
"North Vancouver, BC"	"Canada"
"Kelowna, BC"	"Canada"
"Cloverdale, BC"	"Canada"
"McBride, BC"	"Canada"
"Castlegar, BC"	"Canada"
"Maple Ridge, BC"	"Canada"
"Merritt, BC"	"Canada"
"Abbotsford, BC"	"Canada"
"Courtenay, BC"	"Canada"
"Engineer, BC"	"Canada"
"Winnipeg, MB"	"Canada"
"Scarborough, MB"	"Canada"
"Selkirk, MB"	"Canada"
"Moncton, NB"	"Canada"
"Bathurst, NB"	"Canada"
"Halifax, NS"	"Canada"
"Dartmouth, NS"	"Canada"
"London, ON"	"Canada"
"Burlington, ON"	"Canada"
"Hamilton, ON"	"Canada"
"Waterloo, ON"	"Canada"
"Bolton, ON"	"Canada"
"Vaughan, ON"	"Canada"
"Barrie, ON"	"Canada"
"Windsor, ON"	"Canada"
"Ajax, ON"	"Canada"
"Richmond Hill, ON"	"Canada"
"Scarborough, ON"	"Canada"
"Main Square, ON"	"Canada"
"Listowel, ON"	"Canada"
"Thorold, ON"	"Canada"
"Etobicoke, ON"	"Canada"
"Niagara Falls, ON"	"Canada"
"Milton, ON"	"Canada"
"Owen Sound, ON"	"Canada"
"Kitchener, ON"	"Canada"
"St. Catharines, ON"	"Canada"
"Mississauga Valley, ON"	"Canada"
"Scarborough Station, ON"	"Canada"
"Bloor West Village, ON"	"Canada"
"Keswick, ON"	"Canada"
"Scarborough Junction, ON"	"Canada"
"Whitby, ON"	"Canada"
"Caledon, ON"	"Canada"
"Midtown Toronto, ON"	"Canada"
"Greater Sudbury, ON"	"Canada"
"Newmarket, ON"	"Canada"
"North Toronto, ON"	"Canada"
"Maple, ON"	"Canada"
"Thornhill, ON"	"Canada"
"Lakeshore, ON"	"Canada"
"Bracebridge, ON"	"Canada"
"Waterdown, ON"	"Canada"
"Thunder Bay, ON"	"Canada"
"Ancaster, ON"	"Canada"
"Peterborough, ON"	"Canada"
"Guelph, ON"	"Canada"
"Scarborough Township, ON"	"Canada"
"Stoney Creek, ON"	"Canada"
"Kingston, ON"	"Canada"
"Lindsay, ON"	"Canada"
"Montrose, PE"	"Canada"
"Charlottetown, PE"	"Canada"
"Laval, QC"	"Canada"
"Quebec, QC"	"Canada"
"Brossard, QC"	"Canada"
"Pointe-Claire, QC"	"Canada"
"Vaudreuil-Dorion, QC"	"Canada"
"Cap-Chat, QC"	"Canada"
"Saint-Laurent, QC"	"Canada"
"Longueuil, QC"	"Canada"
"Rosemère, QC"	"Canada"
"Dollard-Des Ormeaux, QC"	"Canada"
"La Prairie, QC"	"Canada"
"Montréal-Ouest, QC"	"Canada"
"Regina, SK"	"Canada"
"Saskatoon, SK"	"Canada"
"Weyburn, SK"	"Canada"
"Moose Jaw, SK"	"Canada"
"Anchorage, AK"	"US"
"Anchor Point, AK"	"US"
"North Pole, AK"	"US"
"Huntsville, AL"	"US"
"Mobile, AL"	"US"
"Theodore, AL"	"US"
"Tuscaloosa, AL"	"US"
"America, AL"	"US"
"Madison, AL"	"US"
"Ashford, AL"	"US"
"Muscle Shoals, AL"	"US"
"Spanish Fort, AL"	"US"
"Fort Payne, AL"	"US"
"Boaz, AL"	"US"
"Florence, AL"	"US"
"Little Rock, AR"	"US"
"Fayetteville, AR"	"US"
"North Little Rock, AR"	"US"
"Rogers, AR"	"US"
"Tunis, AR"	"US"
"Fort Smith, AR"	"US"
"Corning, AR"	"US"
"Conway, AR"	"US"
"Jonesboro, AR"	"US"
"Scottsdale, AZ"	"US"
"Chandler, AZ"	"US"
"Goodyear, AZ"	"US"
"Gilbert, AZ"	"US"
"Glendale, AZ"	"US"
"Mesa, AZ"	"US"
"Peoria, AZ"	"US"
"Kingman, AZ"	"US"
"Surprise, AZ"	"US"
"Arizona State University, AZ"	"US"
"Avondale, AZ"	"US"
"Santan, AZ"	"US"
"El Mirage, AZ"	"US"
"Pasadena, CA"	"US"
"Rancho Cucamonga, CA"	"US"
"Rialto, CA"	"US"
"Sherman Oaks, CA"	"US"
"Newport Beach, CA"	"US"
"Brea, CA"	"US"
"Riverside, CA"	"US"
"Cerritos, CA"	"US"
"Pleasanton, CA"	"US"
"Manhattan Beach, CA"	"US"
"Corte Madera, CA"	"US"
"Newark, CA"	"US"
"Roseville, CA"	"US"
"Temecula, CA"	"US"
"San Luis Obispo, CA"	"US"
"Modesto, CA"	"US"
"Walnut Creek, CA"	"US"
"Thousand Oaks, CA"	"US"
"Santa Rosa, CA"	"US"
"Torrance, CA"	"US"
"Northridge, CA"	"US"
"Concord, CA"	"US"
"Berkeley, CA"	"US"
"Glendale, CA"	"US"
"Valencia, CA"	"US"
"Hayward, CA"	"US"
"Stockton, CA"	"US"
"Vacaville, CA"	"US"
"Mission Viejo, CA"	"US"
"Santa Clarita, CA"	"US"
"Santa Cruz, CA"	"US"
"Culver City, CA"	"US"
"Oakland, CA"	"US"
"Orange, CA"	"US"
"South San Francisco, CA"	"US"
"Palm Desert, CA"	"US"
"West Sacramento, CA"	"US"
"Buena Park, CA"	"US"
"Richmond, CA"	"US"
"Century City, CA"	"US"
"Westminster, CA"	"US"
"Burlingame, CA"	"US"
"Fontana, CA"	"US"
"Downey, CA"	"US"
"Canoga Park, CA"	"US"
"Chino, CA"	"US"
"Santa Maria, CA"	"US"
"Laguna Hills, CA"	"US"
"Simi Valley, CA"	"US"
"San Leandro, CA"	"US"
"Arcadia, CA"	"US"
"Redlands, CA"	"US"
"Fremont, CA"	"US"
"Santa Ana, CA"	"US"
"Mira Loma, CA"	"US"
"Hawthorne, CA"	"US"
"Emeryville, CA"	"US"
"Stanford, CA"	"US"
"El Monte, CA"	"US"
"Rosemead, CA"	"US"
"Patterson, CA"	"US"
"Escondido, CA"	"US"
"Chula Vista, CA"	"US"
"Monterey, CA"	"US"
"Long Beach, CA"	"US"
"Ventura, CA"	"US"
"Anaheim, CA"	"US"
"Walnut, CA"	"US"
"Los Gatos, CA"	"US"
"El Segundo, CA"	"US"
"Burbank, CA"	"US"
"Corona, CA"	"US"
"Milpitas, CA"	"US"
"Campbell, CA"	"US"
"National City, CA"	"US"
"Apple Valley, CA"	"US"
"Topanga, CA"	"US"
"Rohnert Park, CA"	"US"
"Citrus Heights, CA"	"US"
"Livermore, CA"	"US"
"Union City, CA"	"US"
"City of Industry, CA"	"US"
"Capitola, CA"	"US"
"Redwood City, CA"	"US"
"North Sacramento, CA"	"US"
"Encinitas, CA"	"US"
"Perris, CA"	"US"
"Commerce, CA"	"US"
"Hollywood, CA"	"US"
"Azusa, CA"	"US"
"San Carlos, CA"	"US"
"Redding, CA"	"US"
"Bakersfield, CA"	"US"
"Beverly Hills, CA"	"US"
"Lakewood, CA"	"US"
"Tustin, CA"	"US"
"Montebello, CA"	"US"
"Woodland Hills, CA"	"US"
"Paramount, CA"	"US"
"El Centro, CA"	"US"
"Norco, CA"	"US"
"Brisbane, CA"	"US"
"Visalia, CA"	"US"
"Yucaipa, CA"	"US"
"Venice, CA"	"US"
"La Jolla, CA"	"US"
"Tulare, CA"	"US"
"Palm Springs, CA"	"US"
"Temple City, CA"	"US"
"Covina, CA"	"US"
"Cal-Ida, CA"	"US"
"Upland, CA"	"US"
"Calif City, CA"	"US"
"La Puente, CA"	"US"
"Goleta, CA"	"US"
"Artesia, CA"	"US"
"Palmdale, CA"	"US"
"San Pedro, CA"	"US"
"El Sobrante, CA"	"US"
"Martinez, CA"	"US"
"Daly City, CA"	"US"
"East Palo Alto, CA"	"US"
"Chico, CA"	"US"
"Westfield, CA"	"US"
"Foster City, CA"	"US"
"Pacifica, CA"	"US"
"Oxnard, CA"	"US"
"Whittier, CA"	"US"
"Willow Glen, CA"	"US"
"Oceanside, CA"	"US"
"Industry, CA"	"US"
"Inglewood, CA"	"US"
"San Pablo, CA"	"US"
"Rancho Cordova, CA"	"US"
"North Hollywood, CA"	"US"
"Beaumont, CA"	"US"
"Antioch, CA"	"US"
"Moraga, CA"	"US"
"Leimert Park, CA"	"US"
"Fairfield, CA"	"US"
"Chino Hills, CA"	"US"
"Folsom, CA"	"US"
"Danville, CA"	"US"
"Los Altos, CA"	"US"
"Stonestown, CA"	"US"
"Baldwin Park, CA"	"US"
"Carpinteria, CA"	"US"
"Lincoln, CA"	"US"
"Chatsworth, CA"	"US"
"South Gate, CA"	"US"
"Turlock, CA"	"US"
"Fullerton, CA"	"US"
"South San Jose Hills, CA"	"US"
"Lawndale, CA"	"US"
"Lake Forest, CA"	"US"
"La Mesa, CA"	"US"
"Rich, CA"	"US"
"Clovis, CA"	"US"
"Pacoima, CA"	"US"
"Canyon Country, CA"	"US"
"Orinda Village, CA"	"US"
"Morgan Hill, CA"	"US"
"Vernon, CA"	"US"
"Bellflower, CA"	"US"
"Menlo Park, CA"	"US"
"San Rafael, CA"	"US"
"Hermosa Beach, CA"	"US"
"Redondo Beach, CA"	"US"
"Jurupa Valley, CA"	"US"
"Castro Valley, CA"	"US"
"Eagle Rock, CA"	"US"
"Central Valley, CA"	"US"
"La Quinta, CA"	"US"
"Alhambra, CA"	"US"
"Los Banos, CA"	"US"
"Reedley, CA"	"US"
"West Hollywood, CA"	"US"
"Fair Oaks, CA"	"US"
"San Bruno, CA"	"US"
"Huntington Beach, CA"	"US"
"Murrieta, CA"	"US"
"Pleasant Hill, CA"	"US"
"Dublin, CA"	"US"
"Victorville, CA"	"US"
"Montclair, CA"	"US"
"Newbury Park, CA"	"US"
"Atherton, CA"	"US"
"La Verne, CA"	"US"
"Moreno, Riverside, CA"	"US"
"Hillsdale, San Mateo, CA"	"US"
"Aurora, CO"	"US"
"Broomfield, CO"	"US"
"Fort Collins, CO"	"US"
"Littleton, CO"	"US"
"Thornton, CO"	"US"
"Loveland, CO"	"US"
"Westminster, CO"	"US"
"Lone Tree, CO"	"US"
"Lakewood, CO"	"US"
"Longmont, CO"	"US"
"Stapleton, CO"	"US"
"Los Cerritos, CO"	"US"
"Englewood, CO"	"US"
"Southpark, CO"	"US"
"Louisville, CO"	"US"
"Southglenn, CO"	"US"
"Alamosa, CO"	"US"
"Grand Lake, CO"	"US"
"Brighton, CO"	"US"
"Cheshire, CT"	"US"
"New Haven, CT"	"US"
"Danbury, CT"	"US"
"Windsor, CT"	"US"
"Stamford, CT"	"US"
"North Haven, CT"	"US"
"Farmington, CT"	"US"
"Greenwich, CT"	"US"
"Trumbull, CT"	"US"
"Bristol, CT"	"US"
"Meriden, CT"	"US"
"Fairfield, CT"	"US"
"Norwalk, CT"	"US"
"Wallingford, CT"	"US"
"Bridgeport, CT"	"US"
"Hamden, CT"	"US"
"Waterford, CT"	"US"
"North Westchester, CT"	"US"
"East Hartford, CT"	"US"
"Bloomfield, CT"	"US"
"Naugatuck, CT"	"US"
"Manchester, CT"	"US"
"New London, CT"	"US"
"West Hartford, CT"	"US"
"Orange, CT"	"US"
"Shelton, CT"	"US"
"Putnam, CT"	"US"
"Newark, DE"	"US"
"Middletown, DE"	"US"
"Wilmington, DE"	"US"
"New Castle, DE"	"US"
"Christiana, DE"	"US"
"Rehoboth Beach, DE"	"US"
"Israel Haul, DE"	"US"
"Concord, New Castle, DE"	"US"
"Tyson's Corner, Fairf, x	"	"US"
"Gainesville, FL"	"US"
"Miami Beach, FL"	"US"
"Tallahassee, FL"	"US"
"Ruskin, FL"	"US"
"Naples, FL"	"US"
"Fort Myers, FL"	"US"
"Hialeah, FL"	"US"
"Brandon, FL"	"US"
"West Palm Beach, FL"	"US"
"Opa-locka, FL"	"US"
"Sunrise, FL"	"US"
"Saint Petersburg, FL"	"US"
"Wellington, FL"	"US"
"Ocala, FL"	"US"
"Davenport, FL"	"US"
"Sarasota, FL"	"US"
"Merritt Island, FL"	"US"
"Palm Beach Gardens, FL"	"US"
"Plantation, FL"	"US"
"Pensacola, FL"	"US"
"Lakeland, FL"	"US"
"Estero, FL"	"US"
"Altamonte Springs, FL"	"US"
"Bradenton, FL"	"US"
"Saint Cloud, FL"	"US"
"Port St Lucie, FL"	"US"
"Doral, FL"	"US"
"Palmetto, FL"	"US"
"Wesley Chapel, FL"	"US"
"Fort Pierce, FL"	"US"
"Melbourne, FL"	"US"
"Port Saint Joe, FL"	"US"
"South Beach, FL"	"US"
"Longwood, FL"	"US"
"Oviedo, FL"	"US"
"Lake Mary, FL"	"US"
"South Florida, FL"	"US"
"Pompano Beach, FL"	"US"
"Coral Gables, FL"	"US"
"Land O' Lakes, FL"	"US"
"Satellite Beach, FL"	"US"
"Stuart, FL"	"US"
"Delray Beach, FL"	"US"
"Titusville, FL"	"US"
"Sanford, FL"	"US"
"Key West, FL"	"US"
"South Miami, FL"	"US"
"Casselberry, FL"	"US"
"Palm City, FL"	"US"
"Cocoa, FL"	"US"
"Ellenton, FL"	"US"
"Vero Beach, FL"	"US"
"Cape Canaveral, FL"	"US"
"Jupiter, FL"	"US"
"Punta Gorda, FL"	"US"
"Port Charlotte, FL"	"US"
"Mid Florida, FL"	"US"
"Cape Coral, FL"	"US"
"Daytona Beach, FL"	"US"
"Palm Bay, FL"	"US"
"Miami Gardens, FL"	"US"
"Opa Locka, FL"	"US"
"Lawtey, FL"	"US"
"Winter Haven, FL"	"US"
"Lake Buena Vista, FL"	"US"
"Oakland Park, FL"	"US"
"Hypoluxo, FL"	"US"
"Palm Harbor, FL"	"US"
"Plant City, FL"	"US"
"Riverview, FL"	"US"
"Cocoa Beach, FL"	"US"
"Kissimmee, FL"	"US"
"Auburndale, FL"	"US"
"Palm Beach, FL"	"US"
"Pierson, FL"	"US"
"Panama City, FL"	"US"
"Miramar, FL"	"US"
"Weston, FL"	"US"
"Miami Springs, FL"	"US"
"Duluth, GA"	"US"
"Johns Creek, GA"	"US"
"Augusta, GA"	"US"
"Kennesaw, GA"	"US"
"Jefferson, GA"	"US"
"Smyrna, GA"	"US"
"Macon, GA"	"US"
"Lawrenceville, GA"	"US"
"Savannah, GA"	"US"
"Braselton, GA"	"US"
"Marietta, GA"	"US"
"North Atlanta, GA"	"US"
"Decatur, GA"	"US"
"Hiram, GA"	"US"
"Cartersville, GA"	"US"
"Woodstock, GA"	"US"
"Lithia Springs, GA"	"US"
"Columbus, GA"	"US"
"Rincon, GA"	"US"
"Morrow, GA"	"US"
"Dunwoody, GA"	"US"
"Dallas, GA"	"US"
"Berkeley Lake, GA"	"US"
"Lithonia, GA"	"US"
"East Atlanta, GA"	"US"
"Stone Mountain, GA"	"US"
"College Park, GA"	"US"
"Cork, GA"	"US"
"Brunswick, GA"	"US"
"East Point, GA"	"US"
"Dalton, GA"	"US"
"Gainesville, GA"	"US"
"Stockbridge, GA"	"US"
"Snellville, GA"	"US"
"Mableton, GA"	"US"
"Midway, GA"	"US"
"Dock Junction, GA"	"US"
"Union City, GA"	"US"
"Lenox Square Post Office, GA"	"US"
"Richmond Hill, GA"	"US"
"Spain, GA"	"US"
"Riverdale, GA"	"US"
"Lilburn, GA"	"US"
"Douglasville, GA"	"US"
"Tucker, GA"	"US"
"Winder, GA"	"US"
"North Point, GA"	"US"
"Carl, GA"	"US"
"Buckhead, GA"	"US"
"Tyrone, GA"	"US"
"Sylvester, GA"	"US"
"Kahala, HI"	"US"
"Waikïkï, HI"	"US"
"Ewa Beach, HI"	"US"
"Kapolei, HI"	"US"
"Lihue, HI"	"US"
"Hilo, HI"	"US"
"Kahului, HI"	"US"
"Des Moines, IA"	"US"
"Muscatine, IA"	"US"
"Waterloo, IA"	"US"
"Cedar Rapids, IA"	"US"
"Iowa City, IA"	"US"
"Ericson, IA"	"US"
"West Des Moines, IA"	"US"
"Ames, IA"	"US"
"Bettendorf, IA"	"US"
"Boise, ID"	"US"
"Twin Falls, ID"	"US"
"Coeur d'Alene, ID"	"US"
"Mountain Home, ID"	"US"
"Lewiston, ID"	"US"
"Idaho Falls, ID"	"US"
"Post Falls, ID"	"US"
"Meridian, ID"	"US"
"Rexburg, ID"	"US"
"France, ID"	"US"
"Joliet, IL"	"US"
"Monee, IL"	"US"
"Orland Park, IL"	"US"
"Skokie, IL"	"US"
"Aurora, IL"	"US"
"Northbrook, IL"	"US"
"Oak Brook, IL"	"US"
"Oakbrook Terrace, IL"	"US"
"Edwardsville, IL"	"US"
"Crest Hill, IL"	"US"
"Deer Park, IL"	"US"
"Rockford, IL"	"US"
"Lisle, IL"	"US"
"Springfield, IL"	"US"
"Lincoln, IL, OH"	"US"
"Bloomingdale, IL"	"US"
"Matteson, IL"	"US"
"Fairview Heights, IL"	"US"
"Wood Dale, IL"	"US"
"Crete, IL"	"US"
"Mark, IL"	"US"
"Vernon Hills, IL"	"US"
"Oak Park, IL"	"US"
"Lemont, IL"	"US"
"Park Ridge, IL"	"US"
"Havana, IL"	"US"
"Deerfield, IL"	"US"
"Oak Brook Mall Branch, IL"	"US"
"Palatine, IL"	"US"
"Oakbrook Ter, IL"	"US"
"Hodgkins, IL"	"US"
"Evanston, IL"	"US"
"Minooka, IL"	"US"
"Berwyn, IL"	"US"
"Bloomington, IL"	"US"
"Addison, IL"	"US"
"Peoria, IL"	"US"
"Fox Valley, IL"	"US"
"Omaha, IL"	"US"
"Riverside, IL"	"US"
"Alton, IL"	"US"
"Streator, IL"	"US"
"Elmhurst, IL"	"US"
"Romeoville, IL"	"US"
"Lombard, IL"	"US"
"Belvidere, IL"	"US"
"Willowbrook, IL"	"US"
"Plainfield, IL"	"US"
"East Peoria, IL"	"US"
"Champaign, IL"	"US"
"Hinckley, IL"	"US"
"Bolingbrook, IL"	"US"
"Jeffersonville, IN"	"US"
"Evansville, IN"	"US"
"Whitestown, IN"	"US"
"Bloomington, IN"	"US"
"Fishers, IN"	"US"
"Fort Wayne, IN"	"US"
"Mishawaka, IN"	"US"
"South Bend, IN"	"US"
"Columbia City, IN"	"US"
"Gary, IN"	"US"
"North Manchester, IN"	"US"
"Crown Point, IN"	"US"
"Gas City, IN"	"US"
"Lafayette, IN"	"US"
"Goshen, IN"	"US"
"Merrillville, IN"	"US"
"Daleville, IN"	"US"
"Speedway, IN"	"US"
"Muncie, IN"	"US"
"Clinton, IN"	"US"
"Terre Haute, IN"	"US"
"Noblesville, IN"	"US"
"Macy, IN"	"US"
"Greendale, IN"	"US"
"Greenwood, IN"	"US"
"Elkhart, IN"	"US"
"Plainfield, IN"	"US"
"Leawood, KS"	"US"
"Shawnee, KS"	"US"
"Lenexa, KS"	"US"
"Edgerton, KS"	"US"
"Wichita, KS"	"US"
"Topeka, KS"	"US"
"Derby, KS"	"US"
"Garden City, KS"	"US"
"Canada, KS"	"US"
"Gardner, KS"	"US"
"Haysville, KS"	"US"
"Arkansas City, KS"	"US"
"Basehor, KS"	"US"
"Merriam, KS"	"US"
"Fort Scott, KS"	"US"
"Lawrence, KS"	"US"
"Shepherdsville, KY"	"US"
"Winchester, KY"	"US"
"Lexington, KY"	"US"
"Corbin, KY"	"US"
"Campbellsville, KY"	"US"
"Rural, KY"	"US"
"Salyersville, KY"	"US"
"Florence, KY"	"US"
"Hollyhill, KY"	"US"
"Ashland, KY"	"US"
"Covington, KY"	"US"
"Glasgow, KY"	"US"
"Baton Rouge, LA"	"US"
"Metairie, LA"	"US"
"Lafayette, LA"	"US"
"New Orleans, LA"	"US"
"Vidalia, LA"	"US"
"Gonzales, LA"	"US"
"Monroe, LA"	"US"
"Kenner, LA"	"US"
"Shreveport, LA"	"US"
"New Iberia, LA"	"US"
"Port Allen, LA"	"US"
"Moss Bluff, LA"	"US"
"Natick, MA"	"US"
"Springfield, MA"	"US"
"Peabody, MA"	"US"
"Braintree, MA"	"US"
"Holyoke, MA"	"US"
"Dedham, MA"	"US"
"Hingham, MA"	"US"
"Marlborough, MA"	"US"
"Waltham, MA"	"US"
"Fall River, MA"	"US"
"Lowell, MA"	"US"
"Milford, MA"	"US"
"Brookline, MA"	"US"
"Brockton, MA"	"US"
"North Dartmouth, MA"	"US"
"Newton, MA"	"US"
"Salem, MA"	"US"
"Hanover, MA"	"US"
"Auburn, MA"	"US"
"Dartmouth, MA"	"US"
"Beverly, MA"	"US"
"Worcester, MA"	"US"
"North Reading, MA"	"US"
"Duxbury, MA"	"US"
"Downtown Crossing, MA"	"US"
"Everett, MA"	"US"
"Billerica, MA"	"US"
"Townsend, MA"	"US"
"Somerville, MA"	"US"
"Saugus, MA"	"US"
"Medford, MA"	"US"
"Westfield, MA"	"US"
"Mansfield, MA"	"US"
"Sutton, MA"	"US"
"Haverhill, MA"	"US"
"Holliston, MA"	"US"
"Bedford, MA"	"US"
"Leominster, MA"	"US"
"Melrose, MA"	"US"
"Foxboro, MA"	"US"
"Hyannis, MA"	"US"
"North Attleboro, MA"	"US"
"Attleboro, MA"	"US"
"Newbury, MA"	"US"
"Woburn, MA"	"US"
"Sharon, MA"	"US"
"Kingston, MA"	"US"
"Avon, MA"	"US"
"Harvard Sq, MA"	"US"
"Millis, MA"	"US"
"Arlington, MA"	"US"
"Wellesley, MA"	"US"
"Taunton, MA"	"US"
"West Springfield, MA"	"US"
"Framingham, MA"	"US"
"Longmeadow, MA"	"US"
"Towson, MD"	"US"
"Columbia, MD"	"US"
"Rockville, MD"	"US"
"Annapolis, MD"	"US"
"Sparrows Point, MD"	"US"
"Silver Spring, MD"	"US"
"Wheaton, MD"	"US"
"Waldorf, MD"	"US"
"Bel Air, MD"	"US"
"Hanover, MD"	"US"
"North East, MD"	"US"
"Salisbury, MD"	"US"
"Middle Earth, MD"	"US"
"New Carrollton, MD"	"US"
"Largo, MD"	"US"
"Linthicum, MD"	"US"
"Dundalk, MD"	"US"
"Ellicott City, MD"	"US"
"Potomac, MD"	"US"
"Rossville, MD"	"US"
"Centreville, MD"	"US"
"California, MD"	"US"
"Annapolis Rock, MD"	"US"
"Pikesville, MD"	"US"
"Elkridge, MD"	"US"
"Germantown, MD"	"US"
"White Plains, MD"	"US"
"Joppa, MD"	"US"
"China, ME"	"US"
"Portland, ME"	"US"
"South Portland, ME"	"US"
"Sweden, ME"	"US"
"Stockholm, ME"	"US"
"Mexico, ME"	"US"
"Augusta, ME"	"US"
"Saco, ME"	"US"
"Bangor, ME"	"US"
"Scarborough, ME"	"US"
"Orland, ME"	"US"
"Calais, ME"	"US"
"Grand Rapids, MI"	"US"
"Lansing, MI"	"US"
"Shelby Township, MI"	"US"
"Sterling Heights, MI"	"US"
"Livonia, MI"	"US"
"Southfield, MI"	"US"
"Clinton Township, MI"	"US"
"Westland, MI"	"US"
"Kalamazoo, MI"	"US"
"Madison Heights, MI"	"US"
"Rochester, MI"	"US"
"Sac Bay, MI"	"US"
"Flint, MI"	"US"
"Hazel Park, MI"	"US"
"Grand Blanc, MI"	"US"
"Portage, MI"	"US"
"Shelby, MI"	"US"
"Traverse City, MI"	"US"
"Wyoming, MI"	"US"
"Lincoln Park, MI"	"US"
"Saginaw, MI"	"US"
"East Lansing, MI"	"US"
"Brownstown Township, MI"	"US"
"Detroit Beach, MI"	"US"
"Lakeside, MI"	"US"
"Au Sable River Park, MI"	"US"
"Fenton, MI"	"US"
"Rochester Hills, MI"	"US"
"Warren, MI"	"US"
"Flat Rock, MI"	"US"
"Northview, MI"	"US"
"Mount Pleasant, MI"	"US"
"Indian River, MI"	"US"
"Farmington Hills, MI"	"US"
"Hell, MI"	"US"
"Royal Oak, MI"	"US"
"Paw Paw, MI"	"US"
"Oak Park, MI"	"US"
"Tunis, MI"	"US"
"Harper Woods, MI"	"US"
"Dearborn, MI"	"US"
"Grandville, MI"	"US"
"East China, MI"	"US"
"Shakopee, MN"	"US"
"Bloomington, MN"	"US"
"Edina, MN"	"US"
"Roseville, MN"	"US"
"Brooklyn Park, MN"	"US"
"Eagan, MN"	"US"
"Minnetonka, MN"	"US"
"Duluth, MN"	"US"
"Rosemount, MN"	"US"
"Austin, MN"	"US"
"Maplewood, MN"	"US"
"Eden Prairie, MN"	"US"
"Mankato, MN"	"US"
"Saint Paul, MN"	"US"
"Rochester, MN"	"US"
"Plymouth, MN"	"US"
"Lakeville, MN"	"US"
"Woodbury, MN"	"US"
"Townshipin Cities, MN"	"US"
"Des Peres, MO"	"US"
"Saint Peters, MO"	"US"
"Columbia, MO"	"US"
"Hazelwood, MO"	"US"
"Joplin, MO"	"US"
"Springfield, MO"	"US"
"Chesterfield, MO"	"US"
"Lees Summit, MO"	"US"
"Independence, MO"	"US"
"Lon, MO"	"US"
"China, MO"	"US"
"Arnold, MO"	"US"
"Budapest, MO"	"US"
"Doniphan, MO"	"US"
"Shanghai, MO"	"US"
"Wheaton, MO"	"US"
"Guam, MO"	"US"
"Florissant, MO"	"US"
"Lake St Louis, MO"	"US"
"Crestwood, MO"	"US"
"Carrollton, MO"	"US"
"Grandview, MO"	"US"
"Rolla, MO"	"US"
"Cape Girardeau, MO"	"US"
"Africa, MO"	"US"
"Lawson, MO"	"US"
"Eureka, MO"	"US"
"Ridgeland, MS"	"US"
"Hattiesburg, MS"	"US"
"Jackson, MS"	"US"
"Gulfport, MS"	"US"
"Highpoint, MS"	"US"
"Poplarville, MS"	"US"
"Missoula, MT"	"US"
"Bozeman, MT"	"US"
"Billings, MT"	"US"
"Amazon, MT"	"US"
"Helena, MT"	"US"
"Lakeside, MT"	"US"
"Greensboro, NC"	"US"
"Concord, NC"	"US"
"Maiden, NC"	"US"
"Winston-Salem, NC"	"US"
"Fayetteville, NC"	"US"
"Sea Breeze, NC"	"US"
"Research Triangle Park, NC"	"US"
"High Point, NC"	"US"
"Garner, NC"	"US"
"Chapel Hill, NC"	"US"
"Asheville, NC"	"US"
"Rockingham, NC"	"US"
"Cape Colony, NC"	"US"
"Jacksonville, NC"	"US"
"Pineville, NC"	"US"
"Rutherfrd Col, NC"	"US"
"Hickory, NC"	"US"
"Harrisburg, NC"	"US"
"Mooresville, NC"	"US"
"Colfax, NC"	"US"
"Weddington, NC"	"US"
"Wilmington, NC"	"US"
"Cameron, NC"	"US"
"Carrboro, NC"	"US"
"Wilson, NC"	"US"
"Wake Forest, NC"	"US"
"Grand Forks, ND"	"US"
"Bismarck, ND"	"US"
"Omaha, NE"	"US"
"Lincoln, NE"	"US"
"Sacramento, NE"	"US"
"Nashua, NH"	"US"
"Salem, NH"	"US"
"Manchester, NH"	"US"
"Concord, NH"	"US"
"Bedford, NH"	"US"
"New Portsmouth, NH"	"US"
"West Lebanon, NH"	"US"
"Derry, NH"	"US"
"Hanover, NH"	"US"
"Stratham, NH"	"US"
"Short Hills, NJ"	"US"
"Freehold, NJ"	"US"
"Wayne, NJ"	"US"
"Cherry Hill, NJ"	"US"
"Jersey City, NJ"	"US"
"Carteret, NJ"	"US"
"Swedesboro, NJ"	"US"
"Logan Township, NJ"	"US"
"Bridgewater, NJ"	"US"
"Avenel, NJ"	"US"
"Woodcliff Lake, NJ"	"US"
"Rockaway, NJ"	"US"
"Robinsville, NJ"	"US"
"Marlton, NJ"	"US"
"Lawrenceville, NJ"	"US"
"East Brunswick, NJ"	"US"
"Cranbury, NJ"	"US"
"Trenton, NJ"	"US"
"Secaucus, NJ"	"US"
"Florence, NJ"	"US"
"Teterboro, NJ"	"US"
"Parsippany, NJ"	"US"
"Menlo Park, NJ"	"US"
"Deptford Township, NJ"	"US"
"Atlantic City, NJ"	"US"
"Paterson, NJ"	"US"
"Pennsauken, NJ"	"US"
"Eatontown, NJ"	"US"
"Princeton, NJ"	"US"
"Woodbridge, NJ"	"US"
"Union, NJ"	"US"
"Wharton, NJ"	"US"
"Lawrence, NJ"	"US"
"Moonachie, NJ"	"US"
"Flemington, NJ"	"US"
"Glen Ridge, NJ"	"US"
"Jackson, NJ"	"US"
"Elmwood Park, NJ"	"US"
"Roselle, NJ"	"US"
"Woodbury, NJ"	"US"
"Cranbury Station, NJ"	"US"
"Fort Lee, NJ"	"US"
"Voorhees, NJ"	"US"
"Ridgewood, NJ"	"US"
"Maplewood, NJ"	"US"
"Lindenwold, NJ"	"US"
"Cresskill, NJ"	"US"
"Ewing, NJ"	"US"
"Fresh Ponds, NJ"	"US"
"Clifton, NJ"	"US"
"Northfield, NJ"	"US"
"Fort Monmouth, NJ"	"US"
"Bellmawr, NJ"	"US"
"Metuchen, NJ"	"US"
"South Brunswick Terrace, NJ"	"US"
"Riverside, NJ"	"US"
"Whippany, NJ"	"US"
"Bayonne, NJ"	"US"
"Passaic, NJ"	"US"
"Boonton, NJ"	"US"
"Middletown, NJ"	"US"
"Rockaway Valley, NJ"	"US"
"Linden, NJ"	"US"
"Totowa, NJ"	"US"
"Glendora, NJ"	"US"
"Madison, NJ"	"US"
"East Freehold, NJ"	"US"
"Mount Holly, NJ"	"US"
"Fairview, NJ"	"US"
"Mount Laurel, NJ"	"US"
"Moorestown, NJ"	"US"
"Montclair, NJ"	"US"
"Bloomfield, NJ"	"US"
"Sayreville, NJ"	"US"
"Livingston, NJ"	"US"
"Somerset, NJ"	"US"
"West Orange, NJ"	"US"
"St. John's, NL"	"US"
"Middle Arm, NL"	"US"
"Albuquerque, NM"	"US"
"Las Cruces, NM"	"US"
"Madrid, NM"	"US"
"McDonald, NM"	"US"
"Bernalillo, NM"	"US"
"North Las Vegas, NV"	"US"
"Henderson, NV"	"US"
"Sparks, NV"	"US"
"Minden, NV"	"US"
"Fallon, NV"	"US"
"Carson City, NV"	"US"
"Albany, NY"	"US"
"Buffalo, NY"	"US"
"Yonkers, NY"	"US"
"Garden City, NY"	"US"
"Manhasset, NY"	"US"
"Syracuse, NY"	"US"
"Lake Grove, NY"	"US"
"Elmhurst, NY"	"US"
"Victor, NY"	"US"
"Bronx, NY"	"US"
"Flushing, NY"	"US"
"Rochester, NY"	"US"
"Bethpage, NY"	"US"
"Poughkeepsie, NY"	"US"
"Cheektowaga, NY"	"US"
"Valley Stream, NY"	"US"
"Huntington, NY"	"US"
"Massapequa, NY"	"US"
"West Nyack, NY"	"US"
"Amherst, NY"	"US"
"Douglaston, NY"	"US"
"Lancaster, NY"	"US"
"Bay Shore, NY"	"US"
"Middletown, NY"	"US"
"Smithtown, NY"	"US"
"Long Island City, NY"	"US"
"Nanuet, NY"	"US"
"Huntington Station, NY"	"US"
"Colonie, NY"	"US"
"Peekskill, NY"	"US"
"Suffern, NY"	"US"
"Mastic, NY"	"US"
"Holtsville, NY"	"US"
"North Babylon, NY"	"US"
"Northeast, NY"	"US"
"Long Beach, NY"	"US"
"Chappaqua, NY"	"US"
"East Elmhurst, NY"	"US"
"Main Settlement, NY"	"US"
"Chester, NY"	"US"
"Ithaca, NY"	"US"
"Uniondale, NY"	"US"
"Tristates, NY"	"US"
"Fairport, NY"	"US"
"Saratoga Springs, NY"	"US"
"Canandaigua, NY"	"US"
"Jericho, NY"	"US"
"Johnson City, NY"	"US"
"China, NY"	"US"
"Brentwood, NY"	"US"
"Hampton Bays, NY"	"US"
"Clifton Park, NY"	"US"
"New Rochelle, NY"	"US"
"Wantagh, NY"	"US"
"Woodside, NY"	"US"
"Bellerose, NY"	"US"
"Commack, NY"	"US"
"Brookhaven, NY"	"US"
"Roosevelt, NY"	"US"
"Nyack, NY"	"US"
"Troy, NY"	"US"
"Italy, NY"	"US"
"Queens Village, NY"	"US"
"Cicero, NY"	"US"
"Binghamton, NY"	"US"
"Hempstead, NY"	"US"
"Rockland, NY"	"US"
"Farmingdale, NY"	"US"
"Utica, NY"	"US"
"Sea Cliff, NY"	"US"
"Stafford, NY"	"US"
"Hartsdale, NY"	"US"
"North Valley Stream, NY"	"US"
"Great Neck, NY"	"US"
"Nassau, NY"	"US"
"Northport, NY"	"US"
"Massapequa Park, NY"	"US"
"Lenox, NY"	"US"
"Garfield Heights, Cuyahoga, OH"	"US"
"Cleveland Heights, Cuyahoga, OH"	"US"
"Akron, OH"	"US"
"Etna, OH"	"US"
"Euclid, OH"	"US"
"Westlake, OH"	"US"
"Dayton, OH"	"US"
"Obetz, OH"	"US"
"North Randall, OH"	"US"
"Toledo, OH"	"US"
"Mentor, OH"	"US"
"Woodmere, OH"	"US"
"Monroe, OH"	"US"
"Lyndhurst, OH"	"US"
"Fairlawn, OH"	"US"
"Pataskala, OH"	"US"
"New Albany, OH"	"US"
"Groveport, OH"	"US"
"Wilmington, OH"	"US"
"Lorain, OH"	"US"
"Hilliard, OH"	"US"
"Fairfield, OH"	"US"
"Twinsburg, OH"	"US"
"Elyria, OH"	"US"
"Springdale, OH"	"US"
"Ashtabula, OH"	"US"
"Brunswick, OH"	"US"
"Medina, OH"	"US"
"Youngstown, OH"	"US"
"Alliance, OH"	"US"
"North Canton, OH"	"US"
"Grove City, OH"	"US"
"South Euclid, OH"	"US"
"Canton, OH"	"US"
"Zanesville, OH"	"US"
"Upper Arlington, OH"	"US"
"Maple Heights, OH"	"US"
"Hartville, OH"	"US"
"Beavercreek, OH"	"US"
"North Olmsted, OH"	"US"
"Saint Clairsvle, OH"	"US"
"Lakewood, OH"	"US"
"Stow, OH"	"US"
"Norwood, OH"	"US"
"Beachwood, OH"	"US"
"Cincinnati Amf, OH"	"US"
"Kettering, OH"	"US"
"Columbiana, OH"	"US"
"Centerville, OH"	"US"
"Athens, OH"	"US"
"West Chester, OH"	"US"
"Orrville, OH"	"US"
"Worthington, OH"	"US"
"North Benton, OH"	"US"
"Africa, OH"	"US"
"Saint Clairsville, OH"	"US"
"Sheffield Lake, OH"	"US"
"Powell, OH"	"US"
"Warren, OH"	"US"
"Glandorf, OH"	"US"
"Mansfield, OH"	"US"
"Tulsa, OK"	"US"
"Owasso, OK"	"US"
"Shawnee, OK"	"US"
"Nowhere, OK"	"US"
"Broken Arrow, OK"	"US"
"Ardmore, OK"	"US"
"Paden, OK"	"US"
"Bethany, OK"	"US"
"Yukon, OK"	"US"
"Mangum, OK"	"US"
"Midwest City, OK"	"US"
"Orlando, OK"	"US"
"Tigard, OR"	"US"
"Eugene, OR"	"US"
"Salem, OR"	"US"
"Clackamas, OR"	"US"
"Boardman, OR"	"US"
"Hillsboro, OR"	"US"
"Woodburn, OR"	"US"
"Beaverton, OR"	"US"
"Tanasbourne, OR"	"US"
"Umatilla, OR"	"US"
"Gresham, OR"	"US"
"Hermiston, OR"	"US"
"Redmond, OR"	"US"
"Coos Bay, OR"	"US"
"Bend, OR"	"US"
"Lake Oswego, OR"	"US"
"New Princeton, OR"	"US"
"Happy Valley, OR"	"US"
"King of Prussia, PA"	"US"
"Phila, PA"	"US"
"Carlisle, PA"	"US"
"Allentown, PA"	"US"
"Harrisburg, PA"	"US"
"Easton, PA"	"US"
"Langhorne, PA"	"US"
"Lancaster, PA"	"US"
"Whitehall, PA"	"US"
"Willow Grove, PA"	"US"
"Springfield, PA"	"US"
"Ardmore, PA"	"US"
"Hazleton, PA"	"US"
"Breinigsville, PA"	"US"
"State College, PA"	"US"
"Scranton, PA"	"US"
"Hazle Township, PA"	"US"
"Pitts, PA"	"US"
"Erie, PA"	"US"
"Wilkes-Barre, PA"	"US"
"Latrobe, PA"	"US"
"Gouldsboro, PA"	"US"
"Corry, PA"	"US"
"Sewickley, PA"	"US"
"Camp Hill, PA"	"US"
"Homestead, PA"	"US"
"Tarentum, PA"	"US"
"Lewisberry, PA"	"US"
"North Wales, PA"	"US"
"Yardley, PA"	"US"
"Hazle Townshp, PA"	"US"
"Bethlehem, PA"	"US"
"Oxford Valley, PA"	"US"
"Millersville, PA"	"US"
"Bethel Park, PA"	"US"
"Charleroi, PA"	"US"
"New Philadelphia, PA"	"US"
"Havertown, PA"	"US"
"Monaca, PA"	"US"
"West Chester, PA"	"US"
"Drexel Hill, PA"	"US"
"Harborcreek, PA"	"US"
"St. Marys, PA"	"US"
"Sharon, PA"	"US"
"Cambridge Springs, PA"	"US"
"Lower Gwynedd, PA"	"US"
"Eastvale, PA"	"US"
"Lehigh Valley, PA"	"US"
"Harleysville, PA"	"US"
"Exeter, PA"	"US"
"Secane, PA"	"US"
"West Norriton, PA"	"US"
"Denver, PA"	"US"
"Dickson City, PA"	"US"
"Lewisburg, PA"	"US"
"Westland, PA"	"US"
"Swede Hill, PA"	"US"
"Providence, RI"	"US"
"Cumberland, RI"	"US"
"Kingston, RI"	"US"
"Warwick, RI"	"US"
"Cranston, RI"	"US"
"Greenville, SC"	"US"
"Charleston, SC"	"US"
"Columbia, SC"	"US"
"Spartanburg, SC"	"US"
"Myrtle Beach, SC"	"US"
"West Columbia, SC"	"US"
"Clemson, SC"	"US"
"Fort Mill, SC"	"US"
"Rock Hill, SC"	"US"
"North Charleston, SC"	"US"
"Little River, SC"	"US"
"Folly Beach, SC"	"US"
"Privateer, SC"	"US"
"Barnwell, SC"	"US"
"Williamston, SC"	"US"
"Daniel Island, SC"	"US"
"Denmark, SC"	"US"
"Greer, SC"	"US"
"Powdersville, SC"	"US"
"Simpsonville, SC"	"US"
"Mount Pleasant, SC"	"US"
"North Augusta, SC"	"US"
"North Spearfish, SD"	"US"
"Sioux Falls, SD"	"US"
"Aberdeen, SD"	"US"
"Green Hills, Davidson, TN"	"US"
"Chattanooga, TN"	"US"
"Knoxville, TN"	"US"
"Portland, TN"	"US"
"Murfreesboro, TN"	"US"
"Lebanon, TN"	"US"
"Charleston, TN"	"US"
"Collierville, TN"	"US"
"Germantown, TN"	"US"
"India, TN"	"US"
"Franklin, TN"	"US"
"Madison, TN"	"US"
"Jackson, TN"	"US"
"East Chattanooga, TN"	"US"
"Smithwood, TN"	"US"
"Crossville, TN"	"US"
"Savannah, TN"	"US"
"Dickson, TN"	"US"
"Tullahoma, TN"	"US"
"Brentwood, TN"	"US"
"Cool Springs, TN"	"US"
"Elizabethton, TN"	"US"
"Waverly, TN"	"US"
"Oak Hill, Travis, TX"	"US"
"San Marcos, TX"	"US"
"Haslet, TX"	"US"
"Garland, TX"	"US"
"Southlake, TX"	"US"
"The Woodlands, TX"	"US"
"Lubbock, TX"	"US"
"McAllen, TX"	"US"
"Sugar Land, TX"	"US"
"Hurst, TX"	"US"
"College Station, TX"	"US"
"Schertz, TX"	"US"
"Brookshire, TX"	"US"
"Humble, TX"	"US"
"Corpus Christi, TX"	"US"
"Friendswood, TX"	"US"
"McKinney, TX"	"US"
"Killeen, TX"	"US"
"El Paso, TX"	"US"
"India, TX"	"US"
"Addison, TX"	"US"
"Mesquite, TX"	"US"
"Spring, TX"	"US"
"Baytown, TX"	"US"
"Round Rock, TX"	"US"
"Pharr, TX"	"US"
"Temple, TX"	"US"
"Grand Prairie, TX"	"US"
"Pearland, TX"	"US"
"Denton, TX"	"US"
"Little New York, TX"	"US"
"Allen, TX"	"US"
"Little Elm, TX"	"US"
"Fairview, TX"	"US"
"Murphy, TX"	"US"
"Grapevine, TX"	"US"
"Texas City, TX"	"US"
"Longview, TX"	"US"
"Saginaw, TX"	"US"
"Lewisville, TX"	"US"
"Farmers Branch, TX"	"US"
"Crystal Falls, TX"	"US"
"Del Valle, TX"	"US"
"Brenham, TX"	"US"
"Laredo, TX"	"US"
"Trophy Club, TX"	"US"
"Leander, TX"	"US"
"Montgomery, TX"	"US"
"Cedar Park, TX"	"US"
"Germany, TX"	"US"
"Pflugerville, TX"	"US"
"Atlanta, TX"	"US"
"Bryan, TX"	"US"
"Mission, TX"	"US"
"China, TX"	"US"
"Lancaster, TX"	"US"
"Sharyland, TX"	"US"
"DeSoto, TX"	"US"
"Prosper, TX"	"US"
"Balch Springs, TX"	"US"
"South Houston, TX"	"US"
"Rockwall, TX"	"US"
"Hutto, TX"	"US"
"North Richland Hills, TX"	"US"
"Ireland, TX"	"US"
"Luling, TX"	"US"
"Galveston, TX"	"US"
"Magnolia, TX"	"US"
"Bedford, TX"	"US"
"Vidor, TX"	"US"
"San Angelo, TX"	"US"
"Webster, TX"	"US"
"Georgetown, TX"	"US"
"League City, TX"	"US"
"Royse City, TX"	"US"
"Porter, TX"	"US"
"Wilmer, TX"	"US"
"Pasadena, TX"	"US"
"Von Ormy, TX"	"US"
"Deer Park, TX"	"US"
"Terrell, TX"	"US"
"Rhome, TX"	"US"
"Corsicana, TX"	"US"
"West Valley City, UT"	"US"
"Murray, UT"	"US"
"Layton, UT"	"US"
"Orem, UT"	"US"
"Sandy, UT"	"US"
"Provo, UT"	"US"
"Midvale, UT"	"US"
"Santa Clara, UT"	"US"
"Farmington, UT"	"US"
"Bountiful, UT"	"US"
"Taylorsville, UT"	"US"
"Copperton, UT"	"US"
"South Jordan, UT"	"US"
"Highland, UT"	"US"
"Halls Fifth Avenue Condominium, UT"	"US"
"South Salt Lake, UT"	"US"
"West Jordan, UT"	"US"
"Norfolk, VA"	"US"
"Reston, VA"	"US"
"Springfield, VA"	"US"
"McLean, VA"	"US"
"Chester, VA"	"US"
"Chesapeake, VA"	"US"
"Virginia Beach, VA"	"US"
"Ashburn, VA"	"US"
"Sterling, VA"	"US"
"Petersburg, VA"	"US"
"Woodbridge, VA"	"US"
"Dulles, VA"	"US"
"Manassas, VA"	"US"
"Ballston, VA"	"US"
"Short Pump, VA"	"US"
"Chantilly, VA"	"US"
"North Chesterfield, VA"	"US"
"Alexandria, VA"	"US"
"Newport News, VA"	"US"
"Hampton, VA"	"US"
"Henrico, VA"	"US"
"Tysons Corner, VA"	"US"
"Clearbrook, VA"	"US"
"Colonial Heights, VA"	"US"
"Glen Allen, VA"	"US"
"Dinwiddie, VA"	"US"
"Quantico, VA"	"US"
"Lorton, VA"	"US"
"Fair Oaks, VA"	"US"
"Danville, VA"	"US"
"Lynchburg, VA"	"US"
"Falls Church, VA"	"US"
"Radford, VA"	"US"
"Portsmouth, VA"	"US"
"Clarendon, VA"	"US"
"Clear Brook, VA"	"US"
"Annandale, VA"	"US"
"Troutville, VA"	"US"
"Mc Lean, VA"	"US"
"Hampden Sydney, VA"	"US"
"Blacksburg, VA"	"US"
"Ruther Glen, VA"	"US"
"Jamaica, VT"	"US"
"Tacoma, WA"	"US"
"Lynnwood, WA"	"US"
"Kennewick, WA"	"US"
"Everett, WA"	"US"
"Spokane, WA"	"US"
"Tukwila, WA"	"US"
"Bellingham, WA"	"US"
"DuPont, WA"	"US"
"Vancouver, WA"	"US"
"Renton, WA"	"US"
"Puyallup, WA"	"US"
"Olympia, WA"	"US"
"Sumner, WA"	"US"
"West Seattle, WA"	"US"
"Silverdale, WA"	"US"
"Seattle Heights, WA"	"US"
"Pasco, WA"	"US"
"Pullman, WA"	"US"
"Mill Creek, WA"	"US"
"Sammamish, WA"	"US"
"Colville, WA"	"US"
"Mountlake Terrace, WA"	"US"
"Swede Hill, WA"	"US"
"Woodinville, WA"	"US"
"Edmonds, WA"	"US"
"Yakima, WA"	"US"
"Arlington, WA"	"US"
"Moses Lake, WA"	"US"
"Richland, WA"	"US"
"Kirkland, WA"	"US"
"Bainbridge Island, WA"	"US"
"South Seattle, WA"	"US"
"East Wenatchee, WA"	"US"
"Federal Way, WA"	"US"
"Bremerton, WA"	"US"
"Madison, WI"	"US"
"Milwaukee, WI"	"US"
"Wauwatosa, WI"	"US"
"Sussex, WI"	"US"
"Appleton, WI"	"US"
"Saukville, WI"	"US"
"Racine, WI"	"US"
"Lancaster, WI"	"US"
"Eau Claire, WI"	"US"
"Lisbon, WI"	"US"
"New Berlin, WI"	"US"
"Menomonee Falls, WI"	"US"
"Lake Geneva, WI"	"US"
"Whitefish Bay, WI"	"US"
"Glendale, WI"	"US"
"Westfield, WI"	"US"
"Greendale, WI"	"US"
"Martinsburg, WV"	"US"
"Huntington, WV"	"US"
"Morgantown, WV"	"US"
"Parkersburg, WV"	"US"
"Newark, WV"	"US"
"Wheeling, WV"	"US"
"Gilbert, WV"	"US"
"Barboursville, WV"	"US"
"Casper, WY"	"US"
"Reliance, WY"	"US"
"Mundelein, IL"	"US"
"Waukegan, IL"	"US"
"West Dundee, IL"	"US"
"Elgin, IL"	"US"
"Carbondale, IL"	"US"
"Carmel, IN"	"US"
"Chestnut Hill, MA"	"US"
"Oregon City, OR"	"US"
"Norwich, England"	"UK"
"Doncaster, England"	"UK"
"Tilbury, England"	"UK"
"Peterborough, England"	"UK"
"Bolton, England"	"UK"
"Coalville, England"	"UK"
"Basingstoke, England"	"UK"
"Derby, England"	"UK"
"Colchester, England"	"UK"
"Exeter, England"	"UK"
"Luton, East of England, England"	"UK"
"Plymouth, England"	"UK"
"Stratford, London, England"	"UK"
"Portsmouth, South East England, England"	"UK"
"Wolverhampton, England"	"UK"
"Bradford, Yorkshire and the Humber, England"	"UK"
"Croydon, England"	"UK"
"Watford, East of England, England"	"UK"
"Southend-on-Sea, England"	"UK"
"Manchester City Centre, England"	"UK"
"Enfield, England"	"UK"
"Lincoln, England"	"UK"
"Stoke-on-Trent, England"	"UK"
"Chester, England"	"UK"
"Blackpool, England"	"UK"
"Swindon, Wiltshire, South West England, England"	"UK"
"Northampton, England"	"UK"
"Wigan, England"	"UK"
"Gateshead, England"	"UK"
"Darlington, North East England, England"	"UK"
"Bromley, England"	"UK"
"Maidstone, England"	"UK"
"Canterbury, England"	"UK"
"Covent Garden, England"	"UK"
"Basildon, East of England, England"	"UK"
"Tamworth, England"	"UK"
"Cannock, England"	"UK"
"Preston, North West England, England"	"UK"
"Oldham, England"	"UK"
"Bournemouth, England"	"UK"
"Hounslow, England"	"UK"
"Eastbourne, England"	"UK"
"Scunthorpe, England"	"UK"
"Rochester, South East England, England"	"UK"
"Hull, England"	"UK"
"Gloucester, England"	"UK"
"Salford, North West England, England"	"UK"
"Oxford, England"	"UK"
"Cheltenham, England"	"UK"
"Middlesbrough, England"	"UK"
"Durham, England"	"UK"
"Islington, England"	"UK"
"Daventry, England"	"UK"
"Holborn, England"	"UK"
"Chelmsford, England"	"UK"
"Loughborough, England"	"UK"
"Dartford, England"	"UK"
"Winchester, England"	"UK"
"Bedford, England"	"UK"
"West Bromwich, England"	"UK"
"Hayes, England"	"UK"
"Braintree, England"	"UK"
"Gainsborough, England"	"UK"
"Crawley, West Sussex, South East England, England"	"UK"
"Gravesend, England"	"UK"
"Poole, England"	"UK"
"Widnes, England"	"UK"
"Woking, England"	"UK"
"Bath, England"	"UK"
"Crayford, England"	"UK"
"Blackburn, England"	"UK"
"Grays, England"	"UK"
"Greenhithe, England"	"UK"
"Carlisle, England"	"UK"
"Slough, Buckinghamshire, South East England, England"	"UK"
"Grimsby, England"	"UK"
"Highbury, England"	"UK"
"City of London, England"	"UK"
"Wembley, England"	"UK"
"Hatfield, East of England, England"	"UK"
"Staines, England"	"UK"
"Kingston upon Thames, England"	"UK"
"Hartlepool, England"	"UK"
"Polegate, England"	"UK"
"Kegworth, England"	"UK"
"Torquay, England"	"UK"
"Dagenham, England"	"UK"
"Halifax, England"	"UK"
"Wakefield, England"	"UK"
"Telford, England"	"UK"
"West Thurrock, England"	"UK"
"Crewe, England"	"UK"
"Camden Town, England"	"UK"
"Thetford, England"	"UK"
"Ealing, England"	"UK"
"High Wycombe, England"	"UK"
"Barnsley, Yorkshire and the Humber, England"	"UK"
"Shrewsbury, England"	"UK"
"Huddersfield, England"	"UK"
"Shepherds Bush, England"	"UK"
"Newquay, England"	"UK"
"Burnley, England"	"UK"
"Saint Albans, England"	"UK"
"Gatwick, England"	"UK"
"Ridgmont, England"	"UK"
"Rugby, England"	"UK"
"Notting Hill, England"	"UK"
"Heathrow, England"	"UK"
"South Shields, England"	"UK"
"Dudley, England"	"UK"
"Strood, England"	"UK"
"Keighley, England"	"UK"
"Surbiton, England"	"UK"
"Newcastle, England"	"UK"
"Yeovil, England"	"UK"
"Harrogate, England"	"UK"
"Sunderland, North East England, England"	"UK"
"Walsall, England"	"UK"
"Stafford, England"	"UK"
"Tonbridge, England"	"UK"
"North Watford, England"	"UK"
"Harlow, England"	"UK"
"Hastings, England"	"UK"
"Kettering, England"	"UK"
"Kingston, East of England, England"	"UK"
"Gillingham, England"	"UK"
"Redditch, England"	"UK"
"Beccles, England"	"UK"
"Kingston upon Hull, England"	"UK"
"Worksop, England"	"UK"
"Castleford, England"	"UK"
"Stevenage, England"	"UK"
"Uxbridge, England"	"UK"
"London Colney, England"	"UK"
"Welwyn Garden City, England"	"UK"
"Wellingborough, England"	"UK"
"Barnet, England"	"UK"
"Deptford, London, England"	"UK"
"Banbury, England"	"UK"
"Truro, England"	"UK"
"Taunton, England"	"UK"
"Ashford, Kent, South East England, England"	"UK"
"Victoria, England"	"UK"
"Bury, North West England, England"	"UK"
"Oldbury, West Midlands, West Midlands, England"	"UK"
"Accrington, England"	"UK"
"Sheerness, England"	"UK"
"Brentford, England"	"UK"
"Barrow in Furness, England"	"UK"
"Exmouth, England"	"UK"
"Brampton, Cambridgeshire, East of England, England"	"UK"
"Chichester, England"	"UK"
"Ripley, East Midlands, England"	"UK"
"Luton, South West England, England"	"UK"
"Spalding, England"	"UK"
"Southport, England"	"UK"
"Hereford, England"	"UK"
"New Malden, England"	"UK"
"Bobbing, England"	"UK"
"Chatham, England"	"UK"
"Plumstead, London, England"	"UK"
"Orpington, England"	"UK"
"Rawtenstall, England"	"UK"
"Barking, London, England"	"UK"
"Yate, England"	"UK"
"Hammersmith, England"	"UK"
"Hampstead, England"	"UK"
"Folkestone, England"	"UK"
"Fareham, England"	"UK"
"Prescot, England"	"UK"
"Beaconsfield, England"	"UK"
"Runcorn, England"	"UK"
"Newport, South East England, England"	"UK"
"Wirral, England"	"UK"
"Stockport, England"	"UK"
"Hitchin, England"	"UK"
"Thornton Heath, England"	"UK"
"Droitwich, England"	"UK"
"Coseley, England"	"UK"
"Selby, England"	"UK"
"Worcester, England"	"UK"
"Seven Kings, England"	"UK"
"Ripon, England"	"UK"
"Uckfield, England"	"UK"
"Alfreton, England"	"UK"
"Mansfield, England"	"UK"
"Birstall, Yorkshire and the Humber, England"	"UK"
"Ashford, Surrey, South East England, England"	"UK"
"Walton-on-Thames, England"	"UK"
"Colne, North West England, England"	"UK"
"Bridgwater, England"	"UK"
"Bexleyheath, England"	"UK"
"Stratford-upon-Avon, England"	"UK"
"Woodham Ferrers, England"	"UK"
"Shoreditch, England"	"UK"
"Brighton Marina village, England"	"UK"
"Rotherham, England"	"UK"
"Hanworth, England"	"UK"
"Worthing, South East England, England"	"UK"
"Westhoughton, England"	"UK"
"East Grinstead, England"	"UK"
"Harrow, England"	"UK"
"Weston-super-Mare, England"	"UK"
"Saint Helens, West Midlands, England"	"UK"
"Sittingbourne, England"	"UK"
"Strensham, England"	"UK"
"Ellesmere Port, England"	"UK"
"Nuneaton, England"	"UK"
"Newbury, England"	"UK"
"Hillingdon, England"	"UK"
"Sutton, London, England"	"UK"
"Ramsgate, England"	"UK"
"Leeming Bar, England"	"UK"
"Darwen, England"	"UK"
"Richmond, London, England"	"UK"
"Welling, England"	"UK"
"Redhill, South East England, England"	"UK"
"Trowbridge, England"	"UK"
"Royal Leamington Spa, England"	"UK"
"Byfleet, England"	"UK"
"Bescot, England"	"UK"
"Borehamwood, England"	"UK"
"Whitefield, England"	"UK"
"Farringdon, England"	"UK"
"Bilston, England"	"UK"
"Bredbury, England"	"UK"
"Portsmouth, North West England, England"	"UK"
"Weston, North West England, England"	"UK"
"Alnwick, England"	"UK"
"Penzance, England"	"UK"
"Knightsbridge, England"	"UK"
"Billingham, England"	"UK"
"Evesham, England"	"UK"
"Wandsworth, England"	"UK"
"Berwick-Upon-Tweed, England"	"UK"
"Palmers Green, England"	"UK"
"Raunds, England"	"UK"
"Stanmore, England"	"UK"
"Tilbrook, England"	"UK"
"Northwich, England"	"UK"
"Merry Hill, England"	"UK"
"Bromsgrove, England"	"UK"
"Appleby Magna, England"	"UK"
"Waltham Cross, England"	"UK"
"Great Yarmouth, England"	"UK"
"Plymstock, England"	"UK"
"Margate, England"	"UK"
"Ilford, England"	"UK"
"Earls Court, England"	"UK"
"Camberley, England"	"UK"
"Huyton, England"	"UK"
"North Acton, England"	"UK"
"Garston, North West England, England"	"UK"
"Broughton, North West England, England"	"UK"
"Chorleywood, England"	"UK"
"Wednesbury, England"	"UK"
"Macclesfield, England"	"UK"
"Rainham, South East England, England"	"UK"
"Bicester, England"	"UK"
"Hayle, England"	"UK"
"St Ives, England"	"UK"
"Chiswick, England"	"UK"
"Andover, England"	"UK"
"Winsford, North West England, England"	"UK"
"Lichfield, England"	"UK"
"Tiverton, South West England, England"	"UK"
"Lancaster, England"	"UK"
"Eastleigh, England"	"UK"
"Stourbridge, England"	"UK"
"Herne Bay, England"	"UK"
"Thurmaston, England"	"UK"
"Whitfield, South East England, England"	"UK"
"Sutton in Ashfield, England"	"UK"
"Woodgreen, England"	"UK"
"Witham, England"	"UK"
"Notting Hill Gate, England"	"UK"
"Chippenham, South West England, England"	"UK"
"Chesterfield, England"	"UK"
"Kempston, England"	"UK"
"Wythenshawe, England"	"UK"
"Sutton Coldfield, England"	"UK"
"South Mimms, England"	"UK"
"Cleethorpes, England"	"UK"
"Acton, London, England"	"UK"
"Bognor Regis, England"	"UK"
"Canvey Island, England"	"UK"
"Grantham, England"	"UK"
"Great Sankey, England"	"UK"
"Corby, Northamptonshire, East Midlands, England"	"UK"
"Smethwick, England"	"UK"
"Orsett, England"	"UK"
"Bourne End, East of England, England"	"UK"
"Birkenhead, England"	"UK"
"Knaresborough, England"	"UK"
"No Man's Heath, England"	"UK"
"Edmonton, England"	"UK"
"Streatham Hill, England"	"UK"
"Henley on Thames, England"	"UK"
"Trafford Park, England"	"UK"
"Dorchester, South West England, England"	"UK"
"Cobham, Surrey, South East England, England"	"UK"
"Barnsley, South West England, England"	"UK"
"Kidderminster, England"	"UK"
"East Finchley, England"	"UK"
"Friern Barnet, England"	"UK"
"Swanley, England"	"UK"
"Pinner, England"	"UK"
"Wall, England"	"UK"
"Preston, West Midlands, England"	"UK"
"Hackney, England"	"UK"
"Radcliffe, England"	"UK"
"Hoo, England"	"UK"
"Hunslet, England"	"UK"
"Clapham, London, England"	"UK"
"Blyth, North East England, England"	"UK"
"Leigh, North West England, England"	"UK"
"Shirley, London, England"	"UK"
"Branksome, England"	"UK"
"Barrow, England"	"UK"
"Royston, East of England, England"	"UK"
"Warwick, West Midlands, England"	"UK"
"Romford, England"	"UK"
"Purley, England"	"UK"
"Gosforth, North East England, England"	"UK"
"Bermondsey, England"	"UK"
"Faringdon, England"	"UK"
"Barmston, England"	"UK"
"Sleaford, England"	"UK"
"Paddington, England"	"UK"
"Redhill, South West England, England"	"UK"
"Feltham, South West England, England"	"UK"
"Briston, England"	"UK"
"Kingstone, England"	"UK"
"Malvern, England"	"UK"
"Ormskirk, England"	"UK"
"Newcastle under Lyme, England"	"UK"
"Littlehampton, England"	"UK"
"Petersfield, England"	"UK"
"Laindon, England"	"UK"
"Southall, England"	"UK"
"Redcar, England"	"UK"
"West Drayton, London, England"	"UK"
"Barnwood, England"	"UK"
"Didcot, England"	"UK"
"Normanton, Yorkshire and the Humber, England"	"UK"
"South Wigston, England"	"UK"
"Melton Mowbray, England"	"UK"
"Ashington, North East England, England"	"UK"
"Wilnecote, England"	"UK"
"Epsom, England"	"UK"
"Witney, England"	"UK"
"Ashby de la Zouch, England"	"UK"
"Barton, Lancashire, Lancashire, North West England, England"	"UK"
"Farnham, South West England, England"	"UK"
"Long Sutton, East Midlands, England"	"UK"
"Broadheath, England"	"UK"
"Calcot, England"	"UK"
"Basildon, South East England, England"	"UK"
"Sale, England"	"UK"
"Swaffham, England"	"UK"
"Hullavington, England"	"UK"
"Warrington, South East England, England"	"UK"
"Lytham St Annes, England"	"UK"
"Broughton, West Midlands, England"	"UK"
"Salisbury, England"	"UK"
"Newhaven, England"	"UK"
"Clitheroe, England"	"UK"
"Windsor, South East England, England"	"UK"
"Wyboston, England"	"UK"
"Longwell Green, England"	"UK"
"Royal Tunbridge Wells, England"	"UK"
"Ryde, England"	"UK"
"Earlestown, England"	"UK"
"Weymouth, England"	"UK"
"Market Harborough, England"	"UK"
"Felixstowe, England"	"UK"
"Bramley, West Yorkshire, Yorkshire and the Humber, England"	"UK"
"East Tilbury, England"	"UK"
"Chandlers Ford, England"	"UK"
"Falmouth, England"	"UK"
"Mottram, England"	"UK"
"Brighouse, England"	"UK"
"Stroud, England"	"UK"
"Bourne, England"	"UK"
"Hinckley, England"	"UK"
"Rushall, West Midlands, England"	"UK"
"Alrewas, England"	"UK"
"Lowestoft, England"	"UK"
"Wisbech, England"	"UK"
"Thirsk, England"	"UK"
"Urmston, England"	"UK"
"Kentish Town, England"	"UK"
"Cullompton, England"	"UK"
"Altrincham, England"	"UK"
"Rivenhall End, England"	"UK"
"Warren Street, England"	"UK"
"Newton Abbot, England"	"UK"
"Wokingham, England"	"UK"
"Arundel, England"	"UK"
"Skelmersdale, England"	"UK"
"Thornaby-on-Tees, England"	"UK"
"Edgware, England"	"UK"
"Kidlington, England"	"UK"
"Westfield, South East England, England"	"UK"
"Weybridge, England"	"UK"
"Workington, England"	"UK"
"Wanstead, England"	"UK"
"Aylesbury, England"	"UK"
"Cuxton, England"	"UK"
"Hedge End, England"	"UK"
"City of Westminster, England"	"UK"
"Havant, England"	"UK"
"Kingston, West Midlands, England"	"UK"
"North Yorkshire, England"	"UK"
"Belper, England"	"UK"
"Aldershot, England"	"UK"
"Knowsley, England"	"UK"
"Chelmsley Wood, England"	"UK"
"Heckmondwike, England"	"UK"
"Golders Green, England"	"UK"
"Leyton, England"	"UK"
"Aylesford, England"	"UK"
"Saint Johns Wood, England"	"UK"
"Cheam, England"	"UK"
"Fulham, England"	"UK"
"Wolviston, England"	"UK"
"Clapham North, England"	"UK"
"Watford, East Midlands, England"	"UK"
"Stotfold, England"	"UK"
"Ashton-under-Lyne, England"	"UK"
"Chingford, England"	"UK"
"King's Lynn, England"	"UK"
"Balham, England"	"UK"
"Dover, England"	"UK"
"Amersham, England"	"UK"
"Dunstall, England"	"UK"
"Stockton-on-Tees, England"	"UK"
"Chorley, England"	"UK"
"Boston, England"	"UK"
"Haringey, England"	"UK"
"Whitgift, England"	"UK"
"Stock, England"	"UK"
"Towcester, England"	"UK"
"Patchway, England"	"UK"
"Brislington, England"	"UK"
"Erdington, England"	"UK"
"Stansted, England"	"UK"
"Sandbach, England"	"UK"
"Street, England"	"UK"
"Broadstairs, England"	"UK"
"Rayleigh, England"	"UK"
"Bletchley, England"	"UK"
"Kings Norton, England"	"UK"
"Castle Donington, England"	"UK"
"Osmaston, England"	"UK"
"Golborne, England"	"UK"
"Totton, England"	"UK"
"Derry, Northern Ireland"	"UK"
"Craigavon, Northern Ireland"	"UK"
"Newtownards, Northern Ireland"	"UK"
"Newry, Northern Ireland"	"UK"
"Enniskillen, Northern Ireland"	"UK"
"Portadown, Craigavon, Northern Ireland"	"UK"
"Bangor, Northern Ireland"	"UK"
"Crew, Northern Ireland"	"UK"
"Saintfield, Northern Ireland"	"UK"
"Cullybackey, Northern Ireland"	"UK"
"Antrim, Northern Ireland"	"UK"
"Dungannon, Northern Ireland"	"UK"
"Londonderry County Borough, Northern Ireland"	"UK"
"Newtownabbey, Northern Ireland"	"UK"
"Cookstown, Northern Ireland"	"UK"
"Omagh, Northern Ireland"	"UK"
"Aberdeen, Scotland"	"UK"
"Dundee, Scotland"	"UK"
"Livingston, Scotland"	"UK"
"Gourock, Scotland"	"UK"
"Bathgate, Scotland"	"UK"
"East Kilbride, Scotland"	"UK"
"Inverness, Scotland"	"UK"
"Glenrothes, Scotland"	"UK"
"Kilmarnock, Scotland"	"UK"
"Paisley, Scotland"	"UK"
"Stirling, Scotland"	"UK"
"Perth, Scotland"	"UK"
"Falkirk, Scotland"	"UK"
"Grangemouth, Scotland"	"UK"
"Clydebank, West Dunbartonshire, Scotland"	"UK"
"Hamilton, Scotland"	"UK"
"Coatbridge, Scotland"	"UK"
"Ayr, Scotland"	"UK"
"Kirkcaldy, Scotland"	"UK"
"Alloa, Scotland"	"UK"
"Alva, Scotland"	"UK"
"Wishaw, Scotland"	"UK"
"Renfrew, Scotland"	"UK"
"Forfar, Scotland"	"UK"
"New Deer, Scotland"	"UK"
"Port Glasgow, Scotland"	"UK"
"Middlebie, Scotland"	"UK"
"Dumfries, Scotland"	"UK"
"Airdrie, Scotland"	"UK"
"Balloch, Scotland"	"UK"
"Greenock, Scotland"	"UK"
"Bellshill, Scotland"	"UK"
"Carmunnock, Scotland"	"UK"
"Anniesland, Scotland"	"UK"
"Stevenston, Scotland"	"UK"
"Newbridge, Scotland"	"UK"
"Erskine, Scotland"	"UK"
"Newyork, Scotland"	"UK"
"Buckhaven, Scotland"	"UK"
"Motherwell, Scotland"	"UK"
"Bridgend, Wales"	"UK"
"Newport, Newport, Wales"	"UK"
"Pontypool, Wales"	"UK"
"Cwmbran, Wales"	"UK"
"Deeside, Wales"	"UK"
"Llandudno, Wales"	"UK"
"Merthyr Tydfil, Wales"	"UK"
"Aberystwyth, Wales"	"UK"
"Caerphilly, Wales"	"UK"
"Haverfordwest, Wales"	"UK"
"Newtown, Wales"	"UK"
"Magor, Wales"	"UK"
"Wrexham, Wales"	"UK"
"Pencoed, Wales"	"UK"
"Neath, Wales"	"UK"
"Bangor, Gwynedd, Wales"	"UK"
"Pembroke, Wales"	"UK"
"Trostre, Wales"	"UK"
"Barry, Wales"	"UK"
"Porth, Wales"	"UK"
"Skewen, Wales"	"UK"
"Llanharry, Wales"	"UK"
"Rhyl, Wales"	"UK"
"Flint, Wales"	"UK"
"Carmarthen, Wales"	"UK"
"Scurlage, Wales"	"UK"
"Milford Haven, Wales"	"UK"
"Broughton, Wales"	"UK"
"Loughor, Wales"	"UK"
"Merthyr, Wales"	"UK"
"Llanelli, Wales"	"UK"
"Port Talbot, Wales"	"UK"
"Lahore"	"Pakistan"
"Taipei"	"Taiwan"
"Lund, Skåne"	"Sweden"
"Perth, Western Australia"	"Australia"
"Iaşi"	"Romania"
"Tallinn"	"Estonia"
"Calle Blancos"	"Costa Rica"
"Manama"	"Bahrain"
"Curitiba"	"Brazil"
"Málaga"	"Spain"
"Almaty"	"Kazakhstan"
"Zürich"	"Switzerland"
"Riyāḑ"	"Saudi Arabia"
"Galway"	"Ireland"
"Karlskrona"	"Sweden"
"Adelaide"	"Australia"
"İzmir"	"Turkey"
"Muscat"	"Oman"
"San Francisco, Heredia"	"Costa Rica"
"Heredia"	"Costa Rica"
"Casablanca"	"Morocco"
"Aachen"	"Germany"
"Cologne"	"Germany"
"Dübendorf"	"Germany"
"East London"	"Germany"
"Frankfurt (Oder)"	"Germany"
"Glasow, Mecklenburg-Western Pomerania"	"Germany"
"Hamburg"	"Germany"
"Herzogenrath"	"Germany"
"Krefeld"	"Germany"
"Landau in der Pfalz"	"Germany"
"Neumarkt i. d. OPf."	"Germany"
"Regensburg"	"Germany"
"Hyderābād Lines"	"India"
"Hyderābād, Sind"	"India"
"Indi, Uttar Pradesh"	"India"